name=Nivel 8 - Cima del Caos
background=cave
tileSize=64

0,0,0,0,0,0,0,0,0,0,0,0,0,0,0,0,0,0
0,0,0,0,0,0,0,0,0,0,0,0,0,0,0,0,0,0
0,0,0,0,0,0,0,0,0,0,0,0,0,0,0,9,7,7
0,0,0,0,0,0,0,0,0,0,0,0,9,0,1,1,0,0
0,0,0,0,0,0,0,0,0,0,8,4,4,0,0,0,0,0
0,0,0,0,0,0,0,0,8,1,1,0,0,0,0,0,0,0
0,0,0,0,0,0,2,8,4,4,0,0,0,0,0,0,0,0
0,0,0,0,2,8,1,1,0,0,0,0,0,0,0,0,0,0
3,3,0,0,1,0,0,0,0,0,0,0,0,0,0,0,0,0
1,1,1,1,1,1,1,1,1,1,1,1,1,1,1,1,1,1
