name=Nivel 1 - Primer Paso
background=forest
tileSize=64

0,0,0,0,0,0,0,0,0,0,0,0,0,0,0,0,0,0
0,0,0,0,0,0,0,0,0,0,0,0,0,0,0,0,0,1
0,0,0,0,0,0,0,0,0,0,0,0,0,0,0,7,7,1
0,0,0,0,0,0,0,0,0,0,0,0,8,0,1,1,1,1
0,0,0,0,0,0,0,0,0,8,0,1,1,1,0,0,0,0
0,0,0,0,0,0,8,0,1,1,1,0,0,0,0,0,0,0
0,0,0,0,0,1,1,1,0,0,0,0,0,0,0,0,0,0
0,0,3,0,1,0,0,0,0,0,0,0,0,0,0,0,0,0
0,1,1,1,1,0,0,0,0,0,0,0,0,0,0,0,0,0
1,1,1,1,1,1,1,1,1,1,1,1,1,1,1,1,1,1
