name=Nivel 4 - Puente de Cajas
background=snow
tileSize=64

0,0,0,0,0,0,0,0,0,0,0,0,0,0,8,0,7,7
0,0,0,0,0,0,0,0,0,0,0,0,9,0,1,1,0,0
0,0,0,0,0,0,0,0,0,0,8,0,1,1,0,0,0,0
0,0,0,0,0,0,0,0,0,8,1,1,0,0,0,0,0,0
0,0,0,0,0,0,0,0,8,1,1,0,0,0,0,0,0,0
0,0,0,0,0,0,0,0,1,1,0,0,0,0,0,0,0,0
0,0,0,0,0,2,8,0,0,0,0,0,0,0,0,0,0,0
0,0,0,0,0,1,1,1,0,0,0,0,0,0,0,0,0,0
3,3,2,0,0,0,0,0,0,0,0,0,0,0,0,0,0,0
1,1,1,1,1,1,1,1,1,1,1,1,1,1,1,1,1,1
