name=Nivel 7 - Plataformas Cristal
background=snow
tileSize=64

0,0,0,0,0,0,0,0,0,0,0,0,0,0,0,0,0,0
0,0,0,0,0,0,0,0,0,0,0,0,0,0,0,0,0,0
0,0,0,0,0,0,0,0,0,0,0,0,0,0,0,9,7,7
0,0,0,0,0,0,0,0,0,0,0,0,8,0,1,1,0,0
0,0,0,0,0,0,0,0,0,8,0,4,4,0,0,0,0,0
0,0,0,0,0,0,0,8,1,1,1,0,0,0,0,0,0,0
0,0,0,0,8,0,4,4,0,0,0,0,0,0,0,0,0,0
0,0,3,0,1,1,1,0,0,0,0,0,0,0,0,0,0,0
0,1,1,1,0,0,0,0,0,0,0,0,0,0,0,0,0,0
1,1,1,1,1,1,1,1,1,1,1,1,1,1,1,1,1,1
