name=Nivel 6 - Zigzag Tenso
background=forest
tileSize=64

0,0,0,0,0,0,0,0,0,0,0,0,0,0,0,0,0,0
0,0,0,0,0,0,0,0,0,0,0,0,0,0,0,0,0,0
0,0,0,0,0,0,0,0,0,0,0,0,0,0,7,7,0,0
0,0,0,0,0,0,0,0,0,0,0,1,1,1,1,1,0,0
0,0,0,0,0,0,0,0,1,1,0,0,0,0,0,0,0,0
0,0,0,0,0,1,1,0,0,0,1,1,0,0,0,0,0,0
0,0,0,1,1,0,0,1,1,0,0,0,1,1,0,0,0,0
0,0,8,0,0,8,0,0,0,8,0,0,0,8,0,0,0,0
3,3,1,1,0,0,0,0,0,0,0,0,0,0,0,0,0,0
1,1,1,1,5,5,1,1,1,1,5,5,1,1,1,1,1,1
