name=Nivel 2 - Cruce del Abismo
background=desert
tileSize=64

0,0,0,0,0,0,0,0,0,0,0,0,0,0,0,0,0,0
0,0,0,0,0,0,0,0,0,0,0,0,0,0,0,0,0,0
0,0,0,0,0,0,0,0,0,0,0,0,0,0,0,0,0,0
0,0,0,0,0,0,0,0,0,0,0,0,0,0,0,0,0,0
0,0,0,0,0,0,0,0,0,0,0,0,0,0,0,0,0,0
0,0,0,0,0,0,0,0,0,0,0,0,0,0,0,0,0,0
0,0,0,0,0,0,0,0,0,0,0,0,0,0,0,0,0,0
0,0,0,8,0,0,8,9,0,0,8,0,0,8,0,0,0,0
3,3,1,1,0,1,1,0,0,1,1,0,1,1,0,0,7,7
1,1,1,1,0,0,0,0,0,0,0,0,0,0,0,1,1,1
