name=Nivel 5 - Ascenso Coordinado
background=desert
tileSize=64

0,0,0,0,0,0,0,0,0,0,0,0,0,0,0,0,0,0
0,0,0,0,0,0,0,0,0,0,0,0,0,7,7,0,0,0
0,0,0,0,0,0,0,0,0,0,4,4,1,1,1,0,0,0
0,0,0,0,0,0,0,0,2,0,0,0,0,0,0,0,0,0
0,0,0,0,0,0,1,1,1,1,1,0,0,0,0,0,0,0
0,0,0,0,2,0,0,0,0,0,0,8,0,0,0,0,0,0
0,0,0,1,1,1,1,1,0,0,0,0,0,0,0,0,0,0
0,0,8,1,1,0,0,0,0,0,0,0,0,0,0,0,0,0
3,3,1,1,0,0,0,0,0,0,0,0,0,0,0,0,0,0
1,1,1,1,5,5,1,1,1,1,5,5,1,1,1,1,1,1
