name=Nivel 3 - Cruce Mixto
background=cave
tileSize=64

0,0,0,0,0,0,0,0,0,0,0,0,0,0,0,0,0,0
0,0,0,0,0,0,0,0,0,0,0,0,0,0,0,0,7,7
0,0,0,0,0,0,0,0,0,0,0,0,0,8,1,1,0,0
0,0,0,0,0,0,0,0,0,0,0,0,4,4,0,0,0,0
0,0,0,0,0,0,0,0,0,0,8,1,1,0,0,0,0,0
0,0,0,0,0,0,0,0,0,0,1,1,0,0,0,0,0,0
0,0,0,0,0,0,0,0,2,8,0,0,0,0,0,0,0,0
0,0,0,8,0,0,8,0,1,1,0,0,0,0,0,0,0,0
3,3,1,1,0,1,1,0,1,1,0,0,0,0,0,0,0,0
1,1,1,1,0,0,0,0,1,1,1,1,1,1,1,1,1,1
