name=Nivel 6 - Monedas en Cascada
background=forest
tileSize=64

0,0,0,0,0,0,0,0,0,0,0,0,0,0,0,0,0,0
0,0,0,0,0,0,0,0,0,0,0,0,0,0,0,0,0,0
0,0,0,0,0,0,0,0,0,0,0,0,0,0,8,0,7,7
0,0,0,0,0,0,0,0,0,0,0,8,8,1,1,1,0,0
0,0,0,0,0,0,0,0,9,0,1,1,1,0,0,0,0,0
0,0,0,0,0,0,8,0,1,1,0,0,0,0,0,0,0,0
0,0,0,0,8,1,1,1,0,0,0,0,0,0,0,0,0,0
0,0,3,8,1,0,0,0,0,0,0,0,0,0,0,0,0,0
0,1,1,1,1,0,0,0,0,0,0,0,0,0,0,0,0,0
1,1,1,1,1,1,1,1,1,1,1,1,1,1,1,1,1,1
