name=Nivel 3 - Lectura de Ruta
background=cave
tileSize=64

0,0,0,0,0,0,0,0,0,0,0,0,0,0,0,0,0,0
0,0,0,0,0,0,0,0,0,0,0,0,0,0,0,0,7,7
0,0,0,0,0,0,0,0,0,0,0,0,0,1,1,1,0,0
0,0,0,0,0,0,0,0,0,0,1,1,4,0,0,0,0,0
0,0,0,0,0,0,0,1,1,1,0,5,5,0,0,0,0,0
0,0,0,0,1,1,1,0,0,0,0,5,5,0,0,0,0,0
0,0,3,2,0,0,0,0,0,0,0,0,0,0,0,0,0,0
0,1,1,1,0,0,0,0,0,0,0,0,0,0,0,0,0,0
1,1,1,1,1,1,1,1,1,1,1,1,1,1,1,1,1,1
1,1,1,1,1,1,1,1,1,1,1,1,1,1,1,1,1,1
