name=Nivel 5 - Ascenso Final
background=desert
tileSize=64

0,0,0,0,0,0,0,0,0,0,0,0,0,0,8,0,7,7
0,0,0,0,0,0,0,0,0,0,0,0,8,0,1,1,0,0
0,0,0,0,0,0,0,0,0,0,8,0,1,1,0,0,0,0
0,0,0,0,0,0,0,0,0,8,4,4,0,0,0,0,0,0
0,0,0,0,0,0,0,0,9,1,1,0,0,0,0,0,0,0
0,0,0,0,0,0,0,0,1,1,0,0,0,0,0,0,0,0
0,0,0,0,0,0,8,2,0,0,0,0,0,0,0,0,0,0
0,0,0,0,0,1,1,1,1,0,0,0,0,0,0,0,0,0
3,3,2,0,0,0,0,0,0,0,0,0,0,0,0,0,0,0
1,1,1,1,1,0,0,0,0,0,0,0,0,0,0,0,0,0
